"filename", "language", "C#", "comment", "blank", "total"
"e:\Workspace\pvzh_mixed\Assets\Scripts\Abilities\Amphibious.cs", "C#", 3, 0, 1, 4
"e:\Workspace\pvzh_mixed\Assets\Scripts\Abilities\Armored.cs", "C#", 36, 0, 2, 38
"e:\Workspace\pvzh_mixed\Assets\Scripts\Abilities\Bullseye.cs", "C#", 30, 0, 2, 32
"e:\Workspace\pvzh_mixed\Assets\Scripts\Abilities\Charge.cs", "C#", 17, 0, 1, 18
"e:\Workspace\pvzh_mixed\Assets\Scripts\Abilities\Gravestone.cs", "C#", 32, 0, 1, 33
"e:\Workspace\pvzh_mixed\Assets\Scripts\Abilities\Hunt.cs", "C#", 39, 0, 2, 41
"e:\Workspace\pvzh_mixed\Assets\Scripts\Abilities\NoCounterAttack.cs", "C#", 4, 0, 2, 6
"e:\Workspace\pvzh_mixed\Assets\Scripts\Abilities\TeamUp.cs", "C#", 3, 0, 1, 4
"e:\Workspace\pvzh_mixed\Assets\Scripts\Abilities\Vampirism.cs", "C#", 24, 0, 3, 27
"e:\Workspace\pvzh_mixed\Assets\Scripts\Base\Ability.cs", "C#", 38, 0, 3, 41
"e:\Workspace\pvzh_mixed\Assets\Scripts\Base\ActionSequence.cs", "C#", 24, 0, 1, 25
"e:\Workspace\pvzh_mixed\Assets\Scripts\Base\ApplyCardAction.cs", "C#", 29, 0, 1, 30
"e:\Workspace\pvzh_mixed\Assets\Scripts\Base\AttackAction.cs", "C#", 24, 0, 1, 25
"e:\Workspace\pvzh_mixed\Assets\Scripts\Base\BasePanel.cs", "C#", 27, 0, 2, 29
"e:\Workspace\pvzh_mixed\Assets\Scripts\Base\Card.cs", "C#", 246, 0, 6, 252
"e:\Workspace\pvzh_mixed\Assets\Scripts\Base\DrawCardAction.cs", "C#", 16, 0, 1, 17
"e:\Workspace\pvzh_mixed\Assets\Scripts\Base\Entity.cs", "C#", 488, 2, 11, 501
"e:\Workspace\pvzh_mixed\Assets\Scripts\Base\EntityCard.cs", "C#", 282, 0, 3, 285
"e:\Workspace\pvzh_mixed\Assets\Scripts\Base\Environment.cs", "C#", 24, 2, 5, 31
"e:\Workspace\pvzh_mixed\Assets\Scripts\Base\EnvironmentCard.cs", "C#", 30, 0, 2, 32
"e:\Workspace\pvzh_mixed\Assets\Scripts\Base\Game.cs", "C#", 34, 0, 1, 35
"e:\Workspace\pvzh_mixed\Assets\Scripts\Base\GameAction.cs", "C#", 8, 0, 2, 10
"e:\Workspace\pvzh_mixed\Assets\Scripts\Base\TrickCard.cs", "C#", 8, 0, 2, 10
"e:\Workspace\pvzh_mixed\Assets\Scripts\Base\UserItem.cs", "C#", 29, 0, 2, 31
"e:\Workspace\pvzh_mixed\Assets\Scripts\Cards\BaseballZombieCard.cs", "C#", 3, 0, 1, 4
"e:\Workspace\pvzh_mixed\Assets\Scripts\Cards\BerryBlast.cs", "C#", 35, 0, 2, 37
"e:\Workspace\pvzh_mixed\Assets\Scripts\Cards\BonkChoyCard.cs", "C#", 5, 0, 2, 7
"e:\Workspace\pvzh_mixed\Assets\Scripts\Cards\CabbagePultCard.cs", "C#", 3, 0, 1, 4
"e:\Workspace\pvzh_mixed\Assets\Scripts\Cards\CactusCard.cs", "C#", 10, 3, 2, 15
"e:\Workspace\pvzh_mixed\Assets\Scripts\Cards\CattailCard.cs", "C#", 10, 3, 2, 15
"e:\Workspace\pvzh_mixed\Assets\Scripts\Cards\ChimneySweepCard.cs", "C#", 3, 0, 1, 4
"e:\Workspace\pvzh_mixed\Assets\Scripts\Cards\ConeheadCard.cs", "C#", 6, 0, 3, 9
"e:\Workspace\pvzh_mixed\Assets\Scripts\Cards\DogWalkerCard.cs", "C#", 6, 0, 3, 9
"e:\Workspace\pvzh_mixed\Assets\Scripts\Cards\DolphinRiderCard.cs", "C#", 6, 0, 3, 9
"e:\Workspace\pvzh_mixed\Assets\Scripts\Cards\Flourish.cs", "C#", 29, 0, 2, 31
"e:\Workspace\pvzh_mixed\Assets\Scripts\Cards\FunDeadRaiser.cs", "C#", 29, 0, 2, 31
"e:\Workspace\pvzh_mixed\Assets\Scripts\Cards\HibernatingBearyCard.cs", "C#", 3, 0, 1, 4
"e:\Workspace\pvzh_mixed\Assets\Scripts\Cards\LocustSwarm.cs", "C#", 44, 0, 3, 47
"e:\Workspace\pvzh_mixed\Assets\Scripts\Cards\OnionRingsCard.cs", "C#", 3, 0, 1, 4
"e:\Workspace\pvzh_mixed\Assets\Scripts\Cards\PeaPodCard.cs", "C#", 3, 0, 1, 4
"e:\Workspace\pvzh_mixed\Assets\Scripts\Cards\PeaShooterCard.cs", "C#", 3, 0, 0, 3
"e:\Workspace\pvzh_mixed\Assets\Scripts\Cards\RollingStone.cs", "C#", 45, 0, 3, 48
"e:\Workspace\pvzh_mixed\Assets\Scripts\Cards\SkyShooterCard.cs", "C#", 3, 0, 1, 4
"e:\Workspace\pvzh_mixed\Assets\Scripts\Cards\SpikeweedCard.cs", "C#", 20, 0, 2, 22
"e:\Workspace\pvzh_mixed\Assets\Scripts\Cards\SteelMagnoliaCard.cs", "C#", 3, 0, 1, 4
"e:\Workspace\pvzh_mixed\Assets\Scripts\Cards\SumoWrestlerCard.cs", "C#", 6, 0, 3, 9
"e:\Workspace\pvzh_mixed\Assets\Scripts\Cards\SunFlowerCard.cs", "C#", 6, 0, 3, 9
"e:\Workspace\pvzh_mixed\Assets\Scripts\Cards\TeamMascotCard.cs", "C#", 3, 0, 1, 4
"e:\Workspace\pvzh_mixed\Assets\Scripts\Cards\ThreepeaterCard.cs", "C#", 3, 0, 1, 4
"e:\Workspace\pvzh_mixed\Assets\Scripts\Cards\TorchWoodCard.cs", "C#", 6, 0, 2, 8
"e:\Workspace\pvzh_mixed\Assets\Scripts\Cards\VampireZombieCard.cs", "C#", 6, 0, 2, 8
"e:\Workspace\pvzh_mixed\Assets\Scripts\Cards\VitaminZ.cs", "C#", 36, 0, 0, 36
"e:\Workspace\pvzh_mixed\Assets\Scripts\Cards\WallNutCard.cs", "C#", 6, 0, 2, 8
"e:\Workspace\pvzh_mixed\Assets\Scripts\Entities\BaseballZombie.cs", "C#", 3, 0, 1, 4
"e:\Workspace\pvzh_mixed\Assets\Scripts\Entities\BonkChoy.cs", "C#", 37, 1, 2, 40
"e:\Workspace\pvzh_mixed\Assets\Scripts\Entities\CabbagePult.cs", "C#", 18, 1, 2, 21
"e:\Workspace\pvzh_mixed\Assets\Scripts\Entities\Cactus.cs", "C#", 5, 0, 2, 7
"e:\Workspace\pvzh_mixed\Assets\Scripts\Entities\Cattail.cs", "C#", 7, 0, 2, 9
"e:\Workspace\pvzh_mixed\Assets\Scripts\Entities\ChimneySweep.cs", "C#", 18, 1, 2, 21
"e:\Workspace\pvzh_mixed\Assets\Scripts\Entities\Conehead.cs", "C#", 7, 0, 3, 10
"e:\Workspace\pvzh_mixed\Assets\Scripts\Entities\DogWalker.cs", "C#", 7, 0, 2, 9
"e:\Workspace\pvzh_mixed\Assets\Scripts\Entities\DolphinRider.cs", "C#", 7, 0, 2, 9
"e:\Workspace\pvzh_mixed\Assets\Scripts\Entities\HibernatingBeary.cs", "C#", 26, 0, 1, 27
"e:\Workspace\pvzh_mixed\Assets\Scripts\Entities\OnionRings.cs", "C#", 25, 0, 2, 27
"e:\Workspace\pvzh_mixed\Assets\Scripts\Entities\PeaPod.cs", "C#", 23, 1, 2, 26
"e:\Workspace\pvzh_mixed\Assets\Scripts\Entities\PeaShooter.cs", "C#", 7, 0, 3, 10
"e:\Workspace\pvzh_mixed\Assets\Scripts\Entities\SkyShooter.cs", "C#", 18, 1, 2, 21
"e:\Workspace\pvzh_mixed\Assets\Scripts\Entities\SteelMagnolia.cs", "C#", 35, 0, 1, 36
"e:\Workspace\pvzh_mixed\Assets\Scripts\Entities\SumoWrestler.cs", "C#", 122, 0, 2, 124
"e:\Workspace\pvzh_mixed\Assets\Scripts\Entities\SunFlower.cs", "C#", 24, 1, 2, 27
"e:\Workspace\pvzh_mixed\Assets\Scripts\Entities\TeamMascot.cs", "C#", 38, 0, 2, 40
"e:\Workspace\pvzh_mixed\Assets\Scripts\Entities\Threepeater.cs", "C#", 151, 0, 5, 156
"e:\Workspace\pvzh_mixed\Assets\Scripts\Entities\TorchWood.cs", "C#", 62, 0, 2, 64
"e:\Workspace\pvzh_mixed\Assets\Scripts\Entities\VampireZombie.cs", "C#", 22, 0, 2, 24
"e:\Workspace\pvzh_mixed\Assets\Scripts\Entities\WallNut.cs", "C#", 18, 0, 2, 20
"e:\Workspace\pvzh_mixed\Assets\Scripts\Environments\Spikeweed.cs", "C#", 32, 0, 3, 35
"e:\Workspace\pvzh_mixed\Assets\Scripts\Managers\AudioManager.cs", "C#", 94, 0, 3, 97
"e:\Workspace\pvzh_mixed\Assets\Scripts\Managers\BattleFieldSceneManager.cs", "C#", 50, 2, 5, 57
"e:\Workspace\pvzh_mixed\Assets\Scripts\Managers\BattlecryManager.cs", "C#", 39, 2, 3, 44
"e:\Workspace\pvzh_mixed\Assets\Scripts\Managers\ColliderManager.cs", "C#", 68, 0, 11, 79
"e:\Workspace\pvzh_mixed\Assets\Scripts\Managers\FileManager.cs", "C#", 13, 0, 1, 14
"e:\Workspace\pvzh_mixed\Assets\Scripts\Managers\GameManager.cs", "C#", 905, 10, 9, 924
"e:\Workspace\pvzh_mixed\Assets\Scripts\Managers\MainMenuSceneManager.cs", "C#", 48, 12, 5, 65
"e:\Workspace\pvzh_mixed\Assets\Scripts\Managers\MyNetworkManager.cs", "C#", 12, 1, 3, 16
"e:\Workspace\pvzh_mixed\Assets\Scripts\Managers\SceneLoader.cs", "C#", 24, 18, 3, 45
"e:\Workspace\pvzh_mixed\Assets\Scripts\Managers\SelectCardSceneManager.cs", "C#", 12, 0, 1, 13
"e:\Workspace\pvzh_mixed\Assets\Scripts\Managers\SpriteManager.cs", "C#", 60, 0, 3, 63
"e:\Workspace\pvzh_mixed\Assets\Scripts\Managers\UIManager.cs", "C#", 179, 7, 2, 188
"e:\Workspace\pvzh_mixed\Assets\Scripts\Managers\UserManager.cs", "C#", 109, 0, 2, 111
"e:\Workspace\pvzh_mixed\Assets\Scripts\Modules\AtkRenderer.cs", "C#", 40, 2, 5, 47
"e:\Workspace\pvzh_mixed\Assets\Scripts\Modules\AtkUI.cs", "C#", 28, 2, 4, 34
"e:\Workspace\pvzh_mixed\Assets\Scripts\Modules\CardDictionary.cs", "C#", 66, 0, 4, 70
"e:\Workspace\pvzh_mixed\Assets\Scripts\Modules\CardLibrary.cs", "C#", 67, 2, 5, 74
"e:\Workspace\pvzh_mixed\Assets\Scripts\Modules\CostUI.cs", "C#", 16, 2, 4, 22
"e:\Workspace\pvzh_mixed\Assets\Scripts\Modules\Deck.cs", "C#", 28, 0, 2, 30
"e:\Workspace\pvzh_mixed\Assets\Scripts\Modules\DeckInfo.cs", "C#", 12, 0, 2, 14
"e:\Workspace\pvzh_mixed\Assets\Scripts\Modules\EnemyAI.cs", "C#", 135, 0, 3, 138
"e:\Workspace\pvzh_mixed\Assets\Scripts\Modules\HandCards.cs", "C#", 40, 0, 3, 43
"e:\Workspace\pvzh_mixed\Assets\Scripts\Modules\HealthRenderer.cs", "C#", 37, 0, 3, 40
"e:\Workspace\pvzh_mixed\Assets\Scripts\Modules\HealthUI.cs", "C#", 18, 2, 4, 24
"e:\Workspace\pvzh_mixed\Assets\Scripts\Modules\Hero.cs", "C#", 75, 0, 3, 78
"e:\Workspace\pvzh_mixed\Assets\Scripts\Modules\Line.cs", "C#", 67, 2, 7, 76
"e:\Workspace\pvzh_mixed\Assets\Scripts\Modules\PreciseImage.cs", "C#", 11, 0, 2, 13
"e:\Workspace\pvzh_mixed\Assets\Scripts\Modules\Slot.cs", "C#", 154, 0, 3, 157
"e:\Workspace\pvzh_mixed\Assets\Scripts\UIPanels\BattleFieldPanel.cs", "C#", 24, 0, 2, 26
"e:\Workspace\pvzh_mixed\Assets\Scripts\UIPanels\CreateUserPanel.cs", "C#", 28, 0, 2, 30
"e:\Workspace\pvzh_mixed\Assets\Scripts\UIPanels\DeleteUserPanel.cs", "C#", 31, 0, 2, 33
"e:\Workspace\pvzh_mixed\Assets\Scripts\UIPanels\EndGamePanel.cs", "C#", 8, 0, 2, 10
"e:\Workspace\pvzh_mixed\Assets\Scripts\UIPanels\HandCardsPanel.cs", "C#", 23, 0, 3, 26
"e:\Workspace\pvzh_mixed\Assets\Scripts\UIPanels\MainMenuPanel.cs", "C#", 28, 0, 3, 31
"e:\Workspace\pvzh_mixed\Assets\Scripts\UIPanels\MessageBoxPanel.cs", "C#", 13, 0, 2, 15
"e:\Workspace\pvzh_mixed\Assets\Scripts\UIPanels\OptionsPanel.cs", "C#", 31, 0, 2, 33
"e:\Workspace\pvzh_mixed\Assets\Scripts\UIPanels\RenameUserPanel.cs", "C#", 34, 0, 2, 36
"e:\Workspace\pvzh_mixed\Assets\Scripts\UIPanels\SelectCardPanel.cs", "C#", 43, 0, 2, 45
"e:\Workspace\pvzh_mixed\Assets\Scripts\UIPanels\SwitchUserPanel.cs", "C#", 96, 0, 2, 98
"e:\Workspace\pvzh_mixed\Assets\Scripts\UIPanels\TooltipPanel.cs", "C#", 136, 0, 2, 138
"e:\Workspace\pvzh_mixed\Assets\Scripts\UIPanels\TurnPhasePanel.cs", "C#", 18, 0, 2, 20
"Total", "-", 5471, 80, 291, 5842