"filename", "language", "C#", "comment", "blank", "total"
"e:\Workspace\pvzh_mixed\Assets\Scripts\Abilities\Amphibious.cs", "C#", 3, 0, 1, 4
"e:\Workspace\pvzh_mixed\Assets\Scripts\Abilities\Armored.cs", "C#", 36, 0, 2, 38
"e:\Workspace\pvzh_mixed\Assets\Scripts\Abilities\Bullseye.cs", "C#", 30, 0, 2, 32
"e:\Workspace\pvzh_mixed\Assets\Scripts\Abilities\Charge.cs", "C#", 17, 0, 1, 18
"e:\Workspace\pvzh_mixed\Assets\Scripts\Abilities\Gravestone.cs", "C#", 37, 0, 1, 38
"e:\Workspace\pvzh_mixed\Assets\Scripts\Abilities\Hunt.cs", "C#", 44, 0, 2, 46
"e:\Workspace\pvzh_mixed\Assets\Scripts\Abilities\NoCounterAttack.cs", "C#", 4, 0, 2, 6
"e:\Workspace\pvzh_mixed\Assets\Scripts\Abilities\TeamUp.cs", "C#", 3, 0, 1, 4
"e:\Workspace\pvzh_mixed\Assets\Scripts\Abilities\Vampirism.cs", "C#", 28, 0, 3, 31
"e:\Workspace\pvzh_mixed\Assets\Scripts\Base\Ability.cs", "C#", 42, 0, 3, 45
"e:\Workspace\pvzh_mixed\Assets\Scripts\Base\ActionSequence.cs", "C#", 54, 1, 2, 57
"e:\Workspace\pvzh_mixed\Assets\Scripts\Base\BasePanel.cs", "C#", 27, 0, 2, 29
"e:\Workspace\pvzh_mixed\Assets\Scripts\Base\Card.cs", "C#", 185, 0, 5, 190
"e:\Workspace\pvzh_mixed\Assets\Scripts\Base\Entity.cs", "C#", 496, 17, 12, 525
"e:\Workspace\pvzh_mixed\Assets\Scripts\Base\EntityCard.cs", "C#", 261, 0, 3, 264
"e:\Workspace\pvzh_mixed\Assets\Scripts\Base\Environment.cs", "C#", 21, 0, 3, 24
"e:\Workspace\pvzh_mixed\Assets\Scripts\Base\EnvironmentCard.cs", "C#", 42, 0, 2, 44
"e:\Workspace\pvzh_mixed\Assets\Scripts\Base\Game.cs", "C#", 110, 0, 0, 110
"e:\Workspace\pvzh_mixed\Assets\Scripts\Base\GameAction\ApplyCardAction.cs", "C#", 37, 0, 2, 39
"e:\Workspace\pvzh_mixed\Assets\Scripts\Base\GameAction\AttackAction.cs", "C#", 32, 0, 1, 33
"e:\Workspace\pvzh_mixed\Assets\Scripts\Base\GameAction\BattlecryAction.cs", "C#", 30, 0, 1, 31
"e:\Workspace\pvzh_mixed\Assets\Scripts\Base\GameAction\DrawCardAction.cs", "C#", 29, 0, 1, 30
"e:\Workspace\pvzh_mixed\Assets\Scripts\Base\GameAction\EndTurnAction.cs", "C#", 26, 0, 1, 27
"e:\Workspace\pvzh_mixed\Assets\Scripts\Base\GameAction\GameAction.cs", "C#", 44, 0, 1, 45
"e:\Workspace\pvzh_mixed\Assets\Scripts\Base\GameAction\MoveAction.cs", "C#", 36, 0, 1, 37
"e:\Workspace\pvzh_mixed\Assets\Scripts\Base\GameAction\SwitchPhaseAction.cs", "C#", 18, 0, 1, 19
"e:\Workspace\pvzh_mixed\Assets\Scripts\Base\LobbyItem.cs", "C#", 38, 0, 2, 40
"e:\Workspace\pvzh_mixed\Assets\Scripts\Base\TrickCard.cs", "C#", 8, 0, 2, 10
"e:\Workspace\pvzh_mixed\Assets\Scripts\Base\TurnStateMachine.cs", "C#", 35, 0, 1, 36
"e:\Workspace\pvzh_mixed\Assets\Scripts\Base\TurnState\BaseTurnState.cs", "C#", 10, 0, 0, 10
"e:\Workspace\pvzh_mixed\Assets\Scripts\Base\TurnState\DrawCardState.cs", "C#", 48, 0, 5, 53
"e:\Workspace\pvzh_mixed\Assets\Scripts\Base\TurnState\EndTurnState.cs", "C#", 20, 0, 3, 23
"e:\Workspace\pvzh_mixed\Assets\Scripts\Base\TurnState\EnemyTurnState.cs", "C#", 15, 0, 4, 19
"e:\Workspace\pvzh_mixed\Assets\Scripts\Base\TurnState\MyTurnState.cs", "C#", 15, 0, 4, 19
"e:\Workspace\pvzh_mixed\Assets\Scripts\Base\UserItem.cs", "C#", 27, 0, 2, 29
"e:\Workspace\pvzh_mixed\Assets\Scripts\Cards\BaseballZombieCard.cs", "C#", 3, 0, 1, 4
"e:\Workspace\pvzh_mixed\Assets\Scripts\Cards\BerryBlast.cs", "C#", 28, 0, 2, 30
"e:\Workspace\pvzh_mixed\Assets\Scripts\Cards\BonkChoyCard.cs", "C#", 5, 0, 2, 7
"e:\Workspace\pvzh_mixed\Assets\Scripts\Cards\CabbagePultCard.cs", "C#", 3, 0, 1, 4
"e:\Workspace\pvzh_mixed\Assets\Scripts\Cards\CactusCard.cs", "C#", 6, 0, 2, 8
"e:\Workspace\pvzh_mixed\Assets\Scripts\Cards\CatLadyCard.cs", "C#", 6, 0, 3, 9
"e:\Workspace\pvzh_mixed\Assets\Scripts\Cards\CattailCard.cs", "C#", 6, 0, 2, 8
"e:\Workspace\pvzh_mixed\Assets\Scripts\Cards\ChimneySweepCard.cs", "C#", 3, 0, 1, 4
"e:\Workspace\pvzh_mixed\Assets\Scripts\Cards\ConeheadCard.cs", "C#", 6, 0, 3, 9
"e:\Workspace\pvzh_mixed\Assets\Scripts\Cards\DogWalkerCard.cs", "C#", 6, 0, 3, 9
"e:\Workspace\pvzh_mixed\Assets\Scripts\Cards\DolphinRiderCard.cs", "C#", 6, 0, 3, 9
"e:\Workspace\pvzh_mixed\Assets\Scripts\Cards\Flourish.cs", "C#", 22, 0, 2, 24
"e:\Workspace\pvzh_mixed\Assets\Scripts\Cards\FraidyCatCard.cs", "C#", 6, 0, 3, 9
"e:\Workspace\pvzh_mixed\Assets\Scripts\Cards\FunDeadRaiser.cs", "C#", 22, 0, 2, 24
"e:\Workspace\pvzh_mixed\Assets\Scripts\Cards\HibernatingBearyCard.cs", "C#", 3, 0, 1, 4
"e:\Workspace\pvzh_mixed\Assets\Scripts\Cards\LocustSwarm.cs", "C#", 32, 0, 3, 35
"e:\Workspace\pvzh_mixed\Assets\Scripts\Cards\OnionRingsCard.cs", "C#", 3, 0, 1, 4
"e:\Workspace\pvzh_mixed\Assets\Scripts\Cards\PeaPodCard.cs", "C#", 3, 0, 1, 4
"e:\Workspace\pvzh_mixed\Assets\Scripts\Cards\PeaShooterCard.cs", "C#", 3, 0, 0, 3
"e:\Workspace\pvzh_mixed\Assets\Scripts\Cards\PiedPiperCard.cs", "C#", 6, 0, 3, 9
"e:\Workspace\pvzh_mixed\Assets\Scripts\Cards\PodfatherCard.cs", "C#", 3, 0, 1, 4
"e:\Workspace\pvzh_mixed\Assets\Scripts\Cards\RollingStone.cs", "C#", 37, 0, 3, 40
"e:\Workspace\pvzh_mixed\Assets\Scripts\Cards\SkyShooterCard.cs", "C#", 3, 0, 1, 4
"e:\Workspace\pvzh_mixed\Assets\Scripts\Cards\SpikeweedCard.cs", "C#", 20, 0, 2, 22
"e:\Workspace\pvzh_mixed\Assets\Scripts\Cards\SteelMagnoliaCard.cs", "C#", 3, 0, 1, 4
"e:\Workspace\pvzh_mixed\Assets\Scripts\Cards\SumoWrestlerCard.cs", "C#", 6, 0, 3, 9
"e:\Workspace\pvzh_mixed\Assets\Scripts\Cards\SunFlowerCard.cs", "C#", 6, 0, 3, 9
"e:\Workspace\pvzh_mixed\Assets\Scripts\Cards\TeamMascotCard.cs", "C#", 3, 0, 1, 4
"e:\Workspace\pvzh_mixed\Assets\Scripts\Cards\ThreepeaterCard.cs", "C#", 3, 0, 1, 4
"e:\Workspace\pvzh_mixed\Assets\Scripts\Cards\TorchWoodCard.cs", "C#", 6, 0, 2, 8
"e:\Workspace\pvzh_mixed\Assets\Scripts\Cards\VampireZombieCard.cs", "C#", 6, 0, 2, 8
"e:\Workspace\pvzh_mixed\Assets\Scripts\Cards\VitaminZ.cs", "C#", 30, 0, 0, 30
"e:\Workspace\pvzh_mixed\Assets\Scripts\Cards\WallNutCard.cs", "C#", 6, 0, 2, 8
"e:\Workspace\pvzh_mixed\Assets\Scripts\Cards\YetiLunchbox.cs", "C#", 30, 0, 2, 32
"e:\Workspace\pvzh_mixed\Assets\Scripts\Cards\ZombieYetiCard.cs", "C#", 6, 0, 3, 9
"e:\Workspace\pvzh_mixed\Assets\Scripts\Cards\ZookeeperCard.cs", "C#", 6, 0, 2, 8
"e:\Workspace\pvzh_mixed\Assets\Scripts\Entities\BaseballZombie.cs", "C#", 3, 0, 1, 4
"e:\Workspace\pvzh_mixed\Assets\Scripts\Entities\BonkChoy.cs", "C#", 30, 0, 2, 32
"e:\Workspace\pvzh_mixed\Assets\Scripts\Entities\CabbagePult.cs", "C#", 15, 0, 2, 17
"e:\Workspace\pvzh_mixed\Assets\Scripts\Entities\Cactus.cs", "C#", 5, 0, 2, 7
"e:\Workspace\pvzh_mixed\Assets\Scripts\Entities\CatLady.cs", "C#", 51, 2, 2, 55
"e:\Workspace\pvzh_mixed\Assets\Scripts\Entities\Cattail.cs", "C#", 7, 0, 2, 9
"e:\Workspace\pvzh_mixed\Assets\Scripts\Entities\ChimneySweep.cs", "C#", 15, 0, 2, 17
"e:\Workspace\pvzh_mixed\Assets\Scripts\Entities\Conehead.cs", "C#", 7, 0, 3, 10
"e:\Workspace\pvzh_mixed\Assets\Scripts\Entities\DogWalker.cs", "C#", 7, 0, 2, 9
"e:\Workspace\pvzh_mixed\Assets\Scripts\Entities\DolphinRider.cs", "C#", 7, 0, 2, 9
"e:\Workspace\pvzh_mixed\Assets\Scripts\Entities\FraidyCat.cs", "C#", 39, 0, 2, 41
"e:\Workspace\pvzh_mixed\Assets\Scripts\Entities\HibernatingBeary.cs", "C#", 35, 0, 1, 36
"e:\Workspace\pvzh_mixed\Assets\Scripts\Entities\OnionRings.cs", "C#", 22, 0, 2, 24
"e:\Workspace\pvzh_mixed\Assets\Scripts\Entities\PeaPod.cs", "C#", 20, 0, 2, 22
"e:\Workspace\pvzh_mixed\Assets\Scripts\Entities\PeaShooter.cs", "C#", 7, 0, 3, 10
"e:\Workspace\pvzh_mixed\Assets\Scripts\Entities\PiedPiper.cs", "C#", 20, 1, 2, 23
"e:\Workspace\pvzh_mixed\Assets\Scripts\Entities\Podfather.cs", "C#", 23, 0, 1, 24
"e:\Workspace\pvzh_mixed\Assets\Scripts\Entities\SkyShooter.cs", "C#", 15, 0, 2, 17
"e:\Workspace\pvzh_mixed\Assets\Scripts\Entities\SteelMagnolia.cs", "C#", 29, 0, 0, 29
"e:\Workspace\pvzh_mixed\Assets\Scripts\Entities\SumoWrestler.cs", "C#", 105, 1, 2, 108
"e:\Workspace\pvzh_mixed\Assets\Scripts\Entities\SunFlower.cs", "C#", 21, 0, 2, 23
"e:\Workspace\pvzh_mixed\Assets\Scripts\Entities\TeamMascot.cs", "C#", 30, 0, 2, 32
"e:\Workspace\pvzh_mixed\Assets\Scripts\Entities\Threepeater.cs", "C#", 147, 0, 4, 151
"e:\Workspace\pvzh_mixed\Assets\Scripts\Entities\TorchWood.cs", "C#", 51, 0, 2, 53
"e:\Workspace\pvzh_mixed\Assets\Scripts\Entities\VampireZombie.cs", "C#", 7, 0, 2, 9
"e:\Workspace\pvzh_mixed\Assets\Scripts\Entities\WallNut.cs", "C#", 7, 0, 2, 9
"e:\Workspace\pvzh_mixed\Assets\Scripts\Entities\ZombieYeti.cs", "C#", 28, 0, 3, 31
"e:\Workspace\pvzh_mixed\Assets\Scripts\Entities\Zookeeper.cs", "C#", 33, 0, 2, 35
"e:\Workspace\pvzh_mixed\Assets\Scripts\Environments\Spikeweed.cs", "C#", 26, 0, 3, 29
"e:\Workspace\pvzh_mixed\Assets\Scripts\Managers\AudioManager.cs", "C#", 84, 0, 3, 87
"e:\Workspace\pvzh_mixed\Assets\Scripts\Managers\Authentication.cs", "C#", 31, 3, 4, 38
"e:\Workspace\pvzh_mixed\Assets\Scripts\Managers\AuthenticationManager.cs", "C#", 13, 0, 1, 14
"e:\Workspace\pvzh_mixed\Assets\Scripts\Managers\ColliderManager.cs", "C#", 73, 0, 11, 84
"e:\Workspace\pvzh_mixed\Assets\Scripts\Managers\FileManager.cs", "C#", 13, 0, 1, 14
"e:\Workspace\pvzh_mixed\Assets\Scripts\Managers\GameManager.cs", "C#", 640, 23, 7, 670
"e:\Workspace\pvzh_mixed\Assets\Scripts\Managers\InputManager.cs", "C#", 17, 0, 2, 19
"e:\Workspace\pvzh_mixed\Assets\Scripts\Managers\LobbyManager.cs", "C#", 100, 0, 7, 107
"e:\Workspace\pvzh_mixed\Assets\Scripts\Managers\LobbyOrchestrator.cs", "C#", 0, 171, 45, 216
"e:\Workspace\pvzh_mixed\Assets\Scripts\Managers\MyNetworkManager.cs", "C#", 12, 1, 2, 15
"e:\Workspace\pvzh_mixed\Assets\Scripts\Managers\RelayManager.cs", "C#", 45, 0, 2, 47
"e:\Workspace\pvzh_mixed\Assets\Scripts\Managers\SceneLoader.cs", "C#", 71, 20, 2, 93
"e:\Workspace\pvzh_mixed\Assets\Scripts\Managers\SceneManager\BattleFieldSceneManager.cs", "C#", 32, 0, 2, 34
"e:\Workspace\pvzh_mixed\Assets\Scripts\Managers\SceneManager\HelpSceneManager.cs", "C#", 12, 0, 2, 14
"e:\Workspace\pvzh_mixed\Assets\Scripts\Managers\SceneManager\MainMenuSceneManager.cs", "C#", 47, 11, 3, 61
"e:\Workspace\pvzh_mixed\Assets\Scripts\Managers\SceneManager\SelectCardSceneManager.cs", "C#", 14, 0, 1, 15
"e:\Workspace\pvzh_mixed\Assets\Scripts\Managers\SpriteManager.cs", "C#", 72, 0, 3, 75
"e:\Workspace\pvzh_mixed\Assets\Scripts\Managers\UIManager.cs", "C#", 182, 7, 2, 191
"e:\Workspace\pvzh_mixed\Assets\Scripts\Managers\UserManager.cs", "C#", 97, 0, 2, 99
"e:\Workspace\pvzh_mixed\Assets\Scripts\Modules\AtkRenderer.cs", "C#", 34, 2, 5, 41
"e:\Workspace\pvzh_mixed\Assets\Scripts\Modules\AtkUI.cs", "C#", 28, 2, 4, 34
"e:\Workspace\pvzh_mixed\Assets\Scripts\Modules\ButtonSFX.cs", "C#", 11, 0, 2, 13
"e:\Workspace\pvzh_mixed\Assets\Scripts\Modules\CardDictionary.cs", "C#", 67, 0, 4, 71
"e:\Workspace\pvzh_mixed\Assets\Scripts\Modules\CardLibrary.cs", "C#", 67, 2, 5, 74
"e:\Workspace\pvzh_mixed\Assets\Scripts\Modules\CostUI.cs", "C#", 16, 2, 4, 22
"e:\Workspace\pvzh_mixed\Assets\Scripts\Modules\Deck.cs", "C#", 28, 0, 2, 30
"e:\Workspace\pvzh_mixed\Assets\Scripts\Modules\DeckInfo.cs", "C#", 12, 0, 2, 14
"e:\Workspace\pvzh_mixed\Assets\Scripts\Modules\EnemyAI.cs", "C#", 110, 0, 3, 113
"e:\Workspace\pvzh_mixed\Assets\Scripts\Modules\HandCards.cs", "C#", 58, 0, 3, 61
"e:\Workspace\pvzh_mixed\Assets\Scripts\Modules\HealthRenderer.cs", "C#", 31, 0, 3, 34
"e:\Workspace\pvzh_mixed\Assets\Scripts\Modules\HealthUI.cs", "C#", 18, 2, 4, 24
"e:\Workspace\pvzh_mixed\Assets\Scripts\Modules\Hero.cs", "C#", 115, 0, 3, 118
"e:\Workspace\pvzh_mixed\Assets\Scripts\Modules\Line.cs", "C#", 72, 0, 4, 76
"e:\Workspace\pvzh_mixed\Assets\Scripts\Modules\Position.cs", "C#", 24, 0, 2, 26
"e:\Workspace\pvzh_mixed\Assets\Scripts\Modules\PreciseImage.cs", "C#", 11, 0, 2, 13
"e:\Workspace\pvzh_mixed\Assets\Scripts\Modules\Slot.cs", "C#", 123, 0, 2, 125
"e:\Workspace\pvzh_mixed\Assets\Scripts\UIPanels\BattleFieldPanel.cs", "C#", 41, 0, 2, 43
"e:\Workspace\pvzh_mixed\Assets\Scripts\UIPanels\CreateLobbyPanel.cs", "C#", 27, 0, 2, 29
"e:\Workspace\pvzh_mixed\Assets\Scripts\UIPanels\CreateUserPanel.cs", "C#", 32, 0, 2, 34
"e:\Workspace\pvzh_mixed\Assets\Scripts\UIPanels\DeleteUserPanel.cs", "C#", 31, 0, 2, 33
"e:\Workspace\pvzh_mixed\Assets\Scripts\UIPanels\EndGamePanel.cs", "C#", 13, 1, 2, 16
"e:\Workspace\pvzh_mixed\Assets\Scripts\UIPanels\HallPanel.cs", "C#", 83, 6, 5, 94
"e:\Workspace\pvzh_mixed\Assets\Scripts\UIPanels\HandCardsPanel.cs", "C#", 24, 0, 2, 26
"e:\Workspace\pvzh_mixed\Assets\Scripts\UIPanels\HelpPanel.cs", "C#", 18, 0, 2, 20
"e:\Workspace\pvzh_mixed\Assets\Scripts\UIPanels\MainMenuPanel.cs", "C#", 39, 0, 3, 42
"e:\Workspace\pvzh_mixed\Assets\Scripts\UIPanels\MaskPanel.cs", "C#", 13, 0, 2, 15
"e:\Workspace\pvzh_mixed\Assets\Scripts\UIPanels\MessageBoxPanel.cs", "C#", 13, 0, 2, 15
"e:\Workspace\pvzh_mixed\Assets\Scripts\UIPanels\OnlineGamePanel.cs", "C#", 39, 5, 2, 46
"e:\Workspace\pvzh_mixed\Assets\Scripts\UIPanels\OptionsPanel.cs", "C#", 60, 0, 2, 62
"e:\Workspace\pvzh_mixed\Assets\Scripts\UIPanels\RenameUserPanel.cs", "C#", 34, 0, 2, 36
"e:\Workspace\pvzh_mixed\Assets\Scripts\UIPanels\SelectCardPanel.cs", "C#", 43, 0, 3, 46
"e:\Workspace\pvzh_mixed\Assets\Scripts\UIPanels\SwitchUserPanel.cs", "C#", 96, 0, 2, 98
"e:\Workspace\pvzh_mixed\Assets\Scripts\UIPanels\TooltipPanel.cs", "C#", 135, 0, 2, 137
"e:\Workspace\pvzh_mixed\Assets\Scripts\UIPanels\TurnPhasePanel.cs", "C#", 18, 0, 2, 20
"e:\Workspace\pvzh_mixed\Assets\Scripts\Utilities\Helpers.cs", "C#", 18, 0, 2, 20
"e:\Workspace\pvzh_mixed\Assets\Scripts\Utilities\Singleton.cs", "C#", 19, 0, 3, 22
"Total", "-", 6248, 280, 408, 6936