"filename", "language", "C#", "comment", "blank", "total"
"e:\Workspace\pvzh_mixed\Assets\Scripts\AtkUI.cs", "C#", 12, 2, 5, 19
"e:\Workspace\pvzh_mixed\Assets\Scripts\BattleFieldSceneManager.cs", "C#", 44, 2, 3, 49
"e:\Workspace\pvzh_mixed\Assets\Scripts\BerryBlast.cs", "C#", 23, 1, 3, 27
"e:\Workspace\pvzh_mixed\Assets\Scripts\Card.cs", "C#", 158, 2, 4, 164
"e:\Workspace\pvzh_mixed\Assets\Scripts\CardDictionary.cs", "C#", 7, 0, 4, 11
"e:\Workspace\pvzh_mixed\Assets\Scripts\CardLibrary.cs", "C#", 63, 2, 5, 70
"e:\Workspace\pvzh_mixed\Assets\Scripts\ColliderManager.cs", "C#", 77, 2, 5, 84
"e:\Workspace\pvzh_mixed\Assets\Scripts\CommonZombie.cs", "C#", 16, 1, 3, 20
"e:\Workspace\pvzh_mixed\Assets\Scripts\CostUI.cs", "C#", 15, 2, 4, 21
"e:\Workspace\pvzh_mixed\Assets\Scripts\Deck.cs", "C#", 42, 2, 4, 48
"e:\Workspace\pvzh_mixed\Assets\Scripts\DeckInfo.cs", "C#", 11, 0, 2, 13
"e:\Workspace\pvzh_mixed\Assets\Scripts\DeckManager.cs", "C#", 32, 2, 6, 40
"e:\Workspace\pvzh_mixed\Assets\Scripts\Entity.cs", "C#", 145, 2, 3, 150
"e:\Workspace\pvzh_mixed\Assets\Scripts\GameManager.cs", "C#", 525, 42, 8, 575
"e:\Workspace\pvzh_mixed\Assets\Scripts\HandCards.cs", "C#", 44, 2, 6, 52
"e:\Workspace\pvzh_mixed\Assets\Scripts\HealthRenderer.cs", "C#", 16, 2, 4, 22
"e:\Workspace\pvzh_mixed\Assets\Scripts\HealthUI.cs", "C#", 15, 2, 4, 21
"e:\Workspace\pvzh_mixed\Assets\Scripts\Hero.cs", "C#", 35, 2, 4, 41
"e:\Workspace\pvzh_mixed\Assets\Scripts\Line.cs", "C#", 78, 2, 5, 85
"e:\Workspace\pvzh_mixed\Assets\Scripts\MyNetworkManager.cs", "C#", 14, 2, 4, 20
"e:\Workspace\pvzh_mixed\Assets\Scripts\PeaShooter.cs", "C#", 16, 1, 3, 20
"e:\Workspace\pvzh_mixed\Assets\Scripts\SelectCardSceneManager.cs", "C#", 40, 2, 3, 45
"e:\Workspace\pvzh_mixed\Assets\Scripts\SunFlower.cs", "C#", 16, 2, 3, 21
"e:\Workspace\pvzh_mixed\Assets\Scripts\atkRenderer.cs", "C#", 18, 2, 4, 24
"Total", "-", 1462, 81, 99, 1642